#E###
#.#.#
#...#
#F..#
#S###
