#E#######
#.....#P#
##..#...#
#...#VP.#
#.#.###.#
#...#.V.#
#...#..##
#P#...FP#
######S##
