#E#####
#.....#
##..#.#
#....V#
#.#P###
#...#.#
#...#.#
#V...F#
#####S#
