#E#####
#.....#
##..#.#
#...#.#
#.#P#.#
#.....#
#...###
#VF..V#
##S####
