#E#####
#.....#
##..#P#
#...#.#
#.###.#
#.....#
#...###
#F.VV.#
#S#####
